111111111111111
1C000000000C001
101111111111101
101000C00010C01
101011111C10111
10101E00101C001
101011101011101
10100C001010001
1C1111111010111
100C000000100C1
111111111111101
1P0000000C000C1
111111111111111